1111111111
1000000001
1001111001
1001001001
1100001001
1110011001
1010001111
1011000001
1000001101
1011011001
1001001001
10010$1001
1001111111
1000000001
1111111111
