111111111111111
100000000000001
111111111111001
1111111111110#1
111110#00001001
100000001001#01
11#011101101001
110011100#00001
110#11110001111
110111100111111
110100011111111
110001111111111
111101111111111
1110$0111111111
111111111111111
