111111111111111
100011111111111
100000000000011
1#011111111#011
100000111110011
1#0100000000#11
100110011110011
10#11100111#011
100111100000011
1#0111101101111
100000000101111
10#111111000111
1001111110$0111
1#000000#000111
111111111111111
